abrax	standardName=abraxane	genericName=abraxane
abrex	standardName=abraxane	genericName=abraxane
adriam	standardName=adriamycin	genericName=doxorubicin
adriem	standardName=adriamycin	genericName=doxorubicin
adrucil	standardName=adrucil	genericName=fluorouracil
afinitor	standardName=afinitor	genericName=everolimus
afinitor disperz	standardName=afinitor disperz	genericName=everolimus
anastr	standardName=anastrozole	genericName=anastrozole
andro la 200	standardName=andro la 200	genericName=testosterone
androderm	standardName=androderm	genericName=testosterone
androgel	standardName=androgel	genericName=testosterone
android	standardName=android	genericName=methyltestosterone
android-10	standardName=android-10	genericName=methyltestosterone
android-25	standardName=android-25	genericName=methyltestosterone
androxy	standardName=androxy	genericName=fluoxymesterone
aradia	standardName=aredia	genericName=pamidronate
aredia	standardName=aredia	genericName=pamidronate
aremidex	standardName=arimidex	genericName=anastrozole
aridia	standardName=aredia	genericName=pamidronate
arimadex	standardName=arimidex	genericName=anastrozole
arimadix	standardName=arimidex	genericName=anastrozole
arimdex	standardName=arimidex	genericName=anastrozole
arime	standardName=arimidex	genericName=anastrozole
arimedx	standardName=arimidex	genericName=anastrozole
arimex	standardName=arimidex	genericName=anastrozole
arimi	standardName=arimidex	genericName=anastrozole
arimodex	standardName=arimidex	genericName=anastrozole
aromacin	standardName=aromasin	genericName=exemestane
aromasen	standardName=aromasin	genericName=exemestane
aromasi	standardName=aromasin	genericName=exemestane
aromason	standardName=aromasin	genericName=exemestane
aromata	standardName=aromatase inhibitors	genericName=aromatase inhibitors
aromatase inhibitor	standardName=aromatase inhibitors	genericName=aromatase inhibitors
aromatasin	standardName=aromasin	genericName=exemestane
aromate	standardName=aromatase inhibitors	genericName=aromatase inhibitors
aromato	standardName=aromatase inhibitors	genericName=aromatase inhibitors
aveed	standardName=aveed	genericName=testosterone
axiron	standardName=axiron	genericName=testosterone
capcita	standardName=capecitabine	genericName=capecitabine
capeci	standardName=capecitabine	genericName=capecitabine
carboplatin	standardName=carboplatin	genericName=carboplatin
cenestin	standardName=cenestin	genericName=conjugated estrogens
conjugated estrogens	standardName=conjugated estrogens	genericName=conjugated estrogens
cyclophos	standardName=cyclophosphamide	genericName=cyclophosphamide
cytoxa	standardName=cytoxan	genericName=cyclophosphamide
cytoxan lyophilized	standardName=cytoxan lyophilized	genericName=cyclophosphamide
cytoxans	standardName=cytoxan	genericName=cyclophosphamide
cytoxcin	standardName=cytoxan	genericName=cyclophosphamide
cytoxen	standardName=cytoxan	genericName=cyclophosphamide
cytoxene	standardName=cytoxan	genericName=cyclophosphamide
cytoxian	standardName=cytoxan	genericName=cyclophosphamide
cytoxin	standardName=cytoxan	genericName=cyclophosphamide
cytoxine	standardName=cytoxan	genericName=cyclophosphamide
cytoxn	standardName=cytoxan	genericName=cyclophosphamide
cytoxon	standardName=cytoxan	genericName=cyclophosphamide
cytoxsan	standardName=cytoxan	genericName=cyclophosphamide
cytoxy	standardName=cytoxan	genericName=cyclophosphamide
delatestryl	standardName=delatestryl	genericName=testosterone
depo-estradiol	standardName=depo-estradiol	genericName=estradiol
depo-testosterone	standardName=depo-testosterone	genericName=testosterone
depogen	standardName=depogen	genericName=estradiol
dioval 40	standardName=dioval 40	genericName=estradiol
docefrez	standardName=docefrez	genericName=docetaxel
doceta	standardName=docetaxel	genericName=docetaxel
doxoru	standardName=doxorubicin	genericName=doxorubicin
dura-estrin	standardName=dura-estrin	genericName=estradiol
duragen	standardName=duragen	genericName=estradiol
eligard	standardName=eligard	genericName=leuprolide
ellence	standardName=ellence	genericName=epirubicin
enjuvia	standardName=enjuvia	genericName=conjugated estrogens
epirubicin	standardName=epirubicin	genericName=epirubicin
eribulin	standardName=eribulin	genericName=eribulin
esterified estrogens	standardName=esterified estrogens	genericName=esterified estrogens
estra-v 40	standardName=estra-v 40	genericName=estradiol
estrace	standardName=estrace	genericName=estradiol
estradiol	standardName=estradiol	genericName=estradiol
estradiol oral	standardName=estradiol oral	genericName=estradiol
estradiol patch	standardName=estradiol patch	genericName=estradiol
estragyn la 5	standardName=estragyn la 5	genericName=estradiol
estratab	standardName=estratab	genericName=esterified estrogens
estro-cyp	standardName=estro-cyp	genericName=estradiol
estro-span 40	standardName=estro-span 40	genericName=estradiol
everolimus	standardName=everolimus	genericName=everolimus
evista	standardName=evista	genericName=raloxifene
exemestane	standardName=exemestane	genericName=exemestane
fareston	standardName=fareston	genericName=toremifene
faslodex	standardName=faslodex	genericName=fulvestrant
femara	standardName=femara	genericName=letrozole
fluorouracil	standardName=fluorouracil	genericName=fluorouracil
fluoxymesterone	standardName=fluoxymesterone	genericName=fluoxymesterone
fortesta	standardName=fortesta	genericName=testosterone
fulvestrant	standardName=fulvestrant	genericName=fulvestrant
gemcitabine	standardName=gemcitabine	genericName=gemcitabine
gemzar	standardName=gemzar	genericName=gemcitabine
goserelin	standardName=goserelin	genericName=goserelin
gynodiol	standardName=gynodiol	genericName=estradiol
gynogen la 20	standardName=gynogen la 20	genericName=estradiol
halaven	standardName=halaven	genericName=eribulin
halotestin	standardName=halotestin	genericName=fluoxymesterone
hercep	standardName=herceptin	genericName=trastuzumab
ibrance	standardName=ibrance	genericName=palbociclib
ixabepilone	standardName=ixabepilone	genericName=ixabepilone
ixempra	standardName=ixempra	genericName=ixabepilone
lapatinib	standardName=lapatinib	genericName=lapatinib
letroz	standardName=letrozole	genericName=letrozole
leuprolide	standardName=leuprolide	genericName=leuprolide
lupron	standardName=lupron	genericName=leuprolide
lupron depot	standardName=lupron depot	genericName=leuprolide
lupron depot-gyn	standardName=lupron depot-gyn	genericName=leuprolide
lupron depot-ped	standardName=lupron depot-ped	genericName=leuprolide
medidiol 10	standardName=medidiol 10	genericName=estradiol
megace	standardName=megace	genericName=megestrol
megace es	standardName=megace es	genericName=megestrol
megestrol	standardName=megestrol	genericName=megestrol
menaval-20	standardName=menaval-20	genericName=estradiol
menest	standardName=menest	genericName=esterified estrogens
methitest	standardName=methitest	genericName=methyltestosterone
methotrexate	standardName=methotrexate	genericName=methotrexate
methyltestosterone	standardName=methyltestosterone	genericName=methyltestosterone
modafinil	standardName=modafinil	genericName=modafinil
neosar	standardName=neosar	genericName=cyclophosphamide
nolva	standardName=nolvadex	genericName=tamoxifen
onxol	standardName=onxol	genericName=paclitaxel
oreton methyl	standardName=oreton methyl	genericName=methyltestosterone
paclita	standardName=paclitaxel	genericName=paclitaxel
paclitaxel	standardName=paclitaxel	genericName=paclitaxel
paclitaxel protein-bound	standardName=paclitaxel protein-bound	genericName=paclitaxel protein-bound
palbociclib	standardName=palbociclib	genericName=palbociclib
pamidronate	standardName=pamidronate	genericName=pamidronate
perjeta	standardName=perjeta	genericName=pertuzumab
pertuzumab	standardName=pertuzumab	genericName=pertuzumab
pharmorubicin pfs	standardName=pharmorubicin pfs	genericName=pharmorubicin pfs
pharmorubicin rdf	standardName=pharmorubicin rdf	genericName=pharmorubicin rdf
premarin	standardName=premarin	genericName=premarin
premarin intravenous	standardName=premarin intravenous	genericName=premarin intravenous
ralox	standardName=raloxifene	genericName=raloxifene
rheumatrex dose pack	standardName=rheumatrex dose pack	genericName=rheumatrex dose pack
soltamox	standardName=soltamox	genericName=tamoxifen
tamox	standardName=tamoxifen	genericName=tamoxifen
taxal	standardName=taxol	genericName=paclitaxel
taxel	standardName=taxol	genericName=paclitaxel
taxet	standardName=taxotere	genericName=docetaxel
taxol	standardName=taxol	genericName=paclitaxel
taxot	standardName=taxotere	genericName=docetaxel
teslac	standardName=teslac	genericName=teslac
testim	standardName=testim	genericName=testim
testolactone	standardName=testolactone	genericName=testolactone
testopel	standardName=testopel	genericName=testopel
testosterone	standardName=testosterone	genericName=testosterone
testosterone cypionate	standardName=testosterone cypionate	genericName=testosterone cypionate
testosterone enanthate	standardName=testosterone enanthate	genericName=testosterone enanthate
testosterone topical	standardName=testosterone topical	genericName=testosterone topical
testred	standardName=testred	genericName=testred
thioplex	standardName=thioplex	genericName=thioplex
thiotepa	standardName=thiotepa	genericName=thiotepa
toremifene	standardName=toremifene	genericName=toremifene
toxet	standardName=taxotere	genericName=docetaxel
toxot	standardName=taxotere	genericName=docetaxel
trastuz	standardName=trastuzumab	genericName=trastuzumab
trexall	standardName=trexall	genericName=methotrexate
tykerb	standardName=tykerb	genericName=lapatinib
valergen	standardName=valergen	genericName=estradiol
velban	standardName=velban	genericName=vinblastine
viadur	standardName=viadur	genericName=leuprolide
vinblastine	standardName=vinblastine	genericName=vinblastine
virilon	standardName=virilon	genericName=methyltestosterone
vogelxo	standardName=vogelxo	genericName=testosterone
xeloda	standardName=xeloda	genericName=capecitabine
zoladex	standardName=zoladex	genericName=goserelin
