taxol-cytoxan	standardName=taxol-cytoxan	abbreviation=TC
cytoxan-taxol	standardName=taxol-cytoxan	abbreviation=TC
taxotere-cytoxan	standardName=taxotere-cytoxan	abbreviation=TC
cytoxan-taxotere	standardName=taxotere-cytoxan	abbreviation=TC
adriamycin-cytoxan	standardName=adriamycin-cytoxan	abbreviation=AC
cytoxan-adriamycin	standardName=adriamycin-cytoxan	abbreviation=AC
adriamycin-cytoxan-taxol	standardName=adriamycin-cytoxan-taxol	abbreviation=ACT
adriamycin-taxol-cytoxan	standardName=adriamycin-cytoxan-taxol	abbreviation=ACT
taxol-adriamycin-cytoxan	standardName=adriamycin-cytoxan-taxol	abbreviation=ACT
taxol-cytoxan-adriamycin	standardName=adriamycin-cytoxan-taxol	abbreviation=ACT
cytoxan-adriamycin-taxol	standardName=adriamycin-cytoxan-taxol	abbreviation=ACT
cytoxan-taxol-adriamycin	standardName=adriamycin-cytoxan-taxol	abbreviation=ACT
adriamycin-cytoxan-taxotere	standardName=adriamycin-cytoxan-taxotere	abbreviation=TAC
adriamycin-taxotere-cytoxan	standardName=adriamycin-cytoxan-taxotere	abbreviation=TAC
taxotere-adriamycin-cytoxan	standardName=adriamycin-cytoxan-taxotere	abbreviation=TAC
taxotere-cytoxan-adriamycin	standardName=adriamycin-cytoxan-taxotere	abbreviation=TAC
cytoxan-adriamycin-taxotere	standardName=adriamycin-cytoxan-taxotere	abbreviation=TAC
cytoxan-taxotere-adriamycin	standardName=adriamycin-cytoxan-taxotere	abbreviation=TAC
adriamycin-taxol	standardName=adriamycin-taxol	abbreviation=AT
taxol-adriamycin	standardName=adriamycin-taxol	abbreviation=AT
adriamycin-taxotere	standardName=adriamycin-taxotere	abbreviation=AT
taxotere-adriamycin	standardName=adriamycin-taxotere	abbreviation=AT
cytoxan-adriamycin-fluorouracil	standardName=cytoxan-adriamycin-fluorouracil	abbreviation=CAF(FAC)
cytoxan-fluorouracil-adriamycin	standardName=cytoxan-adriamycin-fluorouracil	abbreviation=CAF(FAC)
adriamycin-fluorouracil-cytoxan	standardName=cytoxan-adriamycin-fluorouracil	abbreviation=CAF(FAC)
adriamycin-cytoxan-fluorouracil	standardName=cytoxan-adriamycin-fluorouracil	abbreviation=CAF(FAC)
fluorouracil-adriamycin-cytoxan	standardName=cytoxan-adriamycin-fluorouracil	abbreviation=CAF(FAC)
fluorouracil-cytoxan-adriamycin	standardName=cytoxan-adriamycin-fluorouracil	abbreviation=CAF(FAC)
cytoxan-methotrexate-fluorouracil	standardName=cytoxan-methotrexate-fluorouracil	abbreviation=CMF
cytoxan-fluorouracil-methotrexate	standardName=cytoxan-methotrexate-fluorouracil	abbreviation=CMF
methotrexate-fluorouracil-cytoxan	standardName=cytoxan-methotrexate-fluorouracil	abbreviation=CMF
methotrexate-cytoxan-fluorouracil	standardName=cytoxan-methotrexate-fluorouracil	abbreviation=CMF
fluorouracil-methotrexate-cytoxan	standardName=cytoxan-methotrexate-fluorouracil	abbreviation=CMF
fluorouracil-cytoxan-methotrexate	standardName=cytoxan-methotrexate-fluorouracil	abbreviation=CMF
ellence-cytoxan	standardName=ellence-cytoxan	abbreviation=EC
cytoxan-ellence	standardName=ellence-cytoxan	abbreviation=EC
fluorouracil-ellence-cytoxan-taxotere	standardName=FEC	abbreviation=FEC
fluorouracil-ellence-taxotere-cytoxan	standardName=FEC	abbreviation=FEC
fluorouracil-cytoxan-ellence-taxotere	standardName=FEC	abbreviation=FEC
fluorouracil-cytoxan-taxotere-ellence	standardName=FEC	abbreviation=FEC
fluorouracil-taxotere-cytoxan-ellence	standardName=FEC	abbreviation=FEC
fluorouracil-taxotere-ellence-cytoxan	standardName=FEC	abbreviation=FEC
ellence-fluorouracil-cytoxan-taxotere	standardName=FEC	abbreviation=FEC
ellence-fluorouracil-taxotere-cytoxan	standardName=FEC	abbreviation=FEC
ellence-cytoxan-fluorouracil-taxotere	standardName=FEC	abbreviation=FEC
ellence-cytoxan-taxotere-fluorouracil	standardName=FEC	abbreviation=FEC
ellence-taxotere-cytoxan-fluorouracil	standardName=FEC	abbreviation=FEC
ellence-taxotere-fluorouracil-cytoxan	standardName=FEC	abbreviation=FEC
cytoxan-ellence-fluorouracil-taxotere	standardName=FEC	abbreviation=FEC
cytoxan-ellence-taxotere-fluorouracil	standardName=FEC	abbreviation=FEC
cytoxan-fluorouracil-ellence-taxotere	standardName=FEC	abbreviation=FEC
cytoxan-fluorouracil-taxotere-ellence	standardName=FEC	abbreviation=FEC
cytoxan-taxotere-fluorouracil-ellence	standardName=FEC	abbreviation=FEC
cytoxan-taxotere-ellence-fluorouracil	standardName=FEC	abbreviation=FEC
taxotere-cytoxan-ellence-fluorouracil	standardName=FEC	abbreviation=FEC
taxotere-cytoxan-fluorouracil-ellence	standardName=FEC	abbreviation=FEC
taxotere-ellence-cytoxan-fluorouracil	standardName=FEC	abbreviation=FEC
taxotere-ellence-fluorouracil-cytoxan	standardName=FEC	abbreviation=FEC
taxotere-fluorouracil-ellence-cytoxan	standardName=FEC	abbreviation=FEC
taxotere-fluorouracil-cytoxan-ellence	standardName=FEC	abbreviation=FEC
carboplatin-taxotere	standardName=carboplatin-taxotere	abbreviation=Null
taxotere-carboplatin	standardName=carboplatin-taxotere	abbreviation=Null
taxotere-carboplatin-herceptin	standardName=taxotere-carboplatin-herceptin	abbreviation=TCH
taxotere-herceptin-carboplatin	standardName=taxotere-carboplatin-herceptin	abbreviation=TCH
carboplatin-taxotere-herceptin	standardName=taxotere-carboplatin-herceptin	abbreviation=TCH
carboplatin-herceptin-taxotere	standardName=taxotere-carboplatin-herceptin	abbreviation=TCH
herceptin-carboplatin-taxotere	standardName=taxotere-carboplatin-herceptin	abbreviation=TCH
herceptin-taxotere-carboplatin	standardName=taxotere-carboplatin-herceptin	abbreviation=TCH